  W     W WEWW WWWW 
XW  E WW W W WW     
WWWW WW   W   W    W
   WW WW      W  WWE
   E    W WWW  EW E 
 W       E WW       
W W     W W        E
 W  W W    W        
  EWW  W  W W       
 E      W   EW E    
         WEW    W   
 W    WWWWW  EW     
              W  WWW
WW  W WW   W   W    
W        W   W     W
E    W  W    EEWW   
        WWE         
       W      WE   W
E  WW WW WW   W  W  
   G W    WW  W  W W
