XWW W W      W    W 
W      WW  WE E W W 
     W   W       W  
W  WW E W W      W  
       W   WW W W   
 W W W  WEW  W   W  
    W WW  W         
   W    W     W     
    W  EWW W     W  
  W    W         W  
  W         E WW  WW
W WE          W    W
 W W   W WWWW  W    
 W           W  WEWE
     W  W     EEW  W
               WW WW
      G WW  W    W W
   W        WE W    
W W EW     W    WWW 
         EW W  W E  
